1 0 0 0 1 0 0 0 1
1.0107 0.034674 -3.6055 -0.030666 1.0046 1.26 0 0 1
1.0407 0.044368 -6.7226 -0.045329 0.99026 2.537 0 0 1
1.0155 0.019292 -3.9315 -0.032604 0.99937 1.6512 0 0 1
1.0055 0.026307 -3.0402 -0.029667 1.0016 1.3096 0 0 1
1.0069 0.031083 -2.4401 -0.019617 1.0015 0.84841 0 0 1
1.019 0.027979 -4.1964 -0.034431 1.002 1.6074 0 0 1
1.0267 0.019022 -4.9167 -0.039724 1.0039 1.8094 0 0 1
